111111111111111111111111111111111111111111111111111111111111111
100000000000000000000000000000000000000000000000000000000000001
100000000000000000000000000000000000000000000000000000000000001
100000000000000000000000000000000000000000000000000000000000001
100000000000000000000000000000000000000000000000000000000000001
100000000000000000000000000000000000000000000000000000000000001
100000000000000000000000000000000000000000000000000000000000001
100111000000000000000000011111111110000000000000000000000000001
100000000000000000000000000000000000000000000000000011111001111
100000011111000000000000000000000000000000000000000000000000001
100000000000000000000000000000000000000000000000000000111111101
100000000000000111111110000000000000000001111111000000100000101
100000000000000000000000000000000000000000000000000000101111101
100000000000000000000000000000000000000000000000000000100000001
111111111111111111111111111111111111111111111111111111111111111
