111111111111111111111111111111111111111111111111111111111111111
200000000000000000000000000000000000000000000000000000000000002
200000000000000000000000000000000000000000000000000000000000002
200000000000000000000000000000000000000000000000000000000000002
200000000000000000000000000000000000000000000000000000000000002
200000000000000000000000000000000000000000000000000000000000002
200000000000000000000000000000000000000000000000000000000000002
200111000000000000000000011111111110000000000000000000000000002
200000000000000000000000000000000000000000000000000011111001112
200000011111000000000000000000000000000000000000000000000000002
200000000000000000000000000000000000000000000000000000111111102
200000000000000111111110000000000000000001111111000000200005202
200000000000000000000000000000000000000000000000000000201111202
200000000000000000000000000000000000000000000000000000200000002
211111111111111111111111111111111111111111111111111111211111112
222222222222222222222222222222222222222222222222222222222222222
222222222222222222222222222222222222222222222222222222222222222
222222222222222222222222222222222222222222222222222222222222222
