22222222222222222222222222222222222222222222222222222222222222222222222222222
22222222222222222222222222222222222222222222222222222222222222222222222222222
22222222222222222222222222222222222222222222222222222222222222222222222222222
22222222222222222222222222222222222222222222222222222222222222222222222222222
22222222999999999999999999999999999999999999999999999999999999999999922222222
22222226000000000000000000000000000000000000000000000000000000000000052222222
22222226000000000000000000000000000000000000000000000000000000000000052222222
22222226000000000000000000000000f0000a77777c000000000000000000000000052222222
22222226000000000000000000000000d0000d000000000000000000000000000000052222222
22222226000000000000000000000000d0000d000000000000000000000000000000052222222
22222226000000000000000000000000d0000d000000000000000000000000000000052222222
222222260087c0000000000000000000d0000d000000000000000000000000000000052222222
22222226000000000000000000000000d0000d0000000000000000000008777c0087722222222
2222222600000087777c000000000000d0000d000000000000000000000000000000052222222
22222226000000000000000000000000d0000d00000000000000000000000a77777b052222222
22222226000000000000008777777c00d0000d0000000000877777c000000d00000d052222222
22222226000000000000000000000000e0000d00000000000000000000000d087773052222222
2222222600000000000000000000000000000d00000000000000000000000d000000052222222
22222222111111111111111111111111111112111111111111111111111112111111122222222
22222222222222222222222222222222222222222222222222222222222222222222222222222
22222222222222222222222222222222222222222222222222222222222222222222222222222
22222222222222222222222222222222222222222222222222222222222222222222222222222
